0000000000000000000000000000000000000000000000000000
0000000000000000000000000000000000000000000000000000
0000000000000000022002222200000000000000000000000000
0000000000000000021661111200000000000000000000000000
0000000000000000021111111200000000000000000000000000
0000000000000000021111111200000000000000000000000000
0000000000000000021111111200000000000000000000000000
0000000000000000021111111200000000000000000000000000
0000000000000000022222211200000000000000000000000000
0000000000000000021111111200000000000000000000000000
0000000000000000021111111200000000000000000000000000
0000000000000000021111111200000000000000000000000000
0000000000000000021111111200000000000000000000000000
0000000000000000022221122200000000000000000000000000
0000000000000000022221122200000000000000000000000000
0000000000000000021111111200000000000000000000000000
0000000000000000021111111200000000000000000000000000
0000000000000000021111111200000000000000000000000000
0000000000000000021111111200000000000000000000000000
0000000000000000022222222200000000000000000000000000
0000000000000000000000000000000000000000000000000000
0000000000000000000000000000000000000000000000000000
