0000000000000000000000000000000000000000000000000000
0000000000000000000000000000000000000000000000000000
0000022222222222222222222000000000000000000000000000
0000021111111221111111112000000000000000000000000000
0000021111111221111111112000000000000000000000000000
0000021111111221111111112000000000000000000000000000
0000021111111111111111112000000000000000000000000000
0000021111111111111111112000000000000000000000000000
0000021111111111111111112000000000000000000000000000
0000022222221121111111112000000000000000000000000000
0000021111221121111111112000000000000000000000000000
0000021111221122222222222000000000000000000000000000
0000021111111111111111120000000000000000000000000000
0000021111111111111111120000000000000000000000000000
0000021111221122111111120000000000000000000000000000
0000021111221122111111120000000000000000000000000000
0000022211221122111111120000000000000000000000000000
0000021111111111111111120000000000000000000000000000
0000021111111111111111120000000000000000000000000000
0000022222222222222222220000000000000000000000000000
0000000000000000000000000000000000000000000000000000
0000000000000000000000000000000000000000000000000000