0000000000000000000000000000000000000000000000000000
0000000000000000000000000000000000000000000000000000
0000200022222222222222220000000000000000000000000000
0000216653811111111111520000000000000000000000000000
0000211111711111113117120000000000000000000000000000
0000211411117111222221120000000000000000000000000000
0000258171111131200021120000000000000000000000000000
0000222222222222222221120000000000000000000000000000
0000281111131111111171120000000000000000000000000000
0000271111111711111311520000000000000000000000000000
0000211222222222222222220000000000000000000000000000
0000211111181171111115120000000000000000000000000000
0000211137117111711171120000000000000000000000000000
0000211111112222221111120000000000000000000000000000
0000211111112222221113120000000000000000000000000000
0000211111112211111111120000000000000000000000000000
0000253858312211111111120000000000000000000000000000
0000222222222218221111120000000000000000000000000000
0000000215711111221118120000000000000000000000000000
0000000217111713221111120000000000000000000000000000
0000000211111111227337120000000000000000000000000000
0000000211111175227575120000000000000000000000000000
0000000222222222222222220000000000000000000000000000
0000000000000000000000000000000000000000000000000000
0000000000000000000000000000000000000000000000000000
