0000000000000000000000000000000000000000000000000000
0000000000000000000000000000000000000000000000000000
0000002222222000000000002200222220000000000000000000
0000002115112000000000002126181120000000000000000000
0000002131312000000000002111117120000000000000000000
0000002111112000000000002111411120000000000000000000
0000002171112222220000002311111720000000000000000000
0000002111111131120000002113111120000000000000000000
0000002111111111120000002171111120000000000000000000
0000002111112228120000002111111120000000000000000000
0000002222222021120000002711113120000000000000000000
0000000000000021122222222111111120000000000000000000
0000000000000021111111311111171120000000000000000000
0000000000000021311111111111113120000000000000000000
0000000000000022222812222181115120000000000000000000
0000000000000222222112222222222220000000000000000000
0000000000000211711111120000000000000000000000000000
0000000000000211311131120000000000000000000000000000
0000000000000211711171120000000000000000000000000000
0000000000000231113111320000000000000000000000000000
0000000000000281511151820000000000000000000000000000
0000000000000222222222220000000000000000000000000000
0000000000000000000000000000000000000000000000000000
0000000000000000000000000000000000000000000000000000
0000000000000000000000000000000000000000000000000000