0000000000000000000000000000000000000000000000000000
0000000000000000000000000000000000000000000000000000
0000000222222000000000000000000000000000000000000000
0000000281712000000000006600000000000000000000000000
0000000211112222222222221120000000000000000000000000
0000000211112281131113111120000000000000000000000000
0000000251112271111111111120000000000000000000000000
0000000022312241111115112200000000000000000000000000
0000000002112217111111782000000000000000000000000000
0022222222112222222221120000000000000000000000000000
0025311111111111111221120000000000000000000000000000
0025311111111111111223820000000000000000000000000000
0022221122221122211221120000000000000000000000000000
0022221122221120211221120000000000000000000000000000
0025311111111120211221120000000000000000000000000000
0021718781711120211221120000000000000000000000000000
0021111111111120218221320000000000000000000000000000
0023757575758320211111120000000000000000000000000000
0022222222222220211111120000000000000000000000000000
0000000000000000215351320000000000000000000000000000
0000000000000000222222220000000000000000000000000000
0000000000000000000000000000000000000000000000000000
0000000000000000000000000000000000000000000000000000
0000000000000000000000000000000000000000000000000000
0000000000000000000000000000000000000000000000000000