0000000000000000000000000000000000000000000000000000
0000000000000000000000000000000000000000000000000000
0000000000000000000000000000000000000000000000000000
0000000000000000022002222200000000000000000000000000
0000000000000000021265118200000000000000000000000000
0000000000000000021111141200000000000000000000000000
0000000000000000021171111200000000000000000000000000
0000000000000000023111113200000000000000000000000000
0000000000000000021711171200000000000000000000000000
0000000000000000022222211200000000000000000000000000
0000000000000000025111811200000000000000000000000000
0000000000000000023711131200000000000000000000000000
0000000000000000021111111200000000000000000000000000
0000000000000000028711113200000000000000000000000000
0000000000000000022221122200000000000000000000000000
0000000000000000022221122200000000000000000000000000
0000000000000000028731378200000000000000000000000000
0000000000000000021111111200000000000000000000000000
0000000000000000021711171200000000000000000000000000
0000000000000000021511115200000000000000000000000000
0000000000000000022222222200000000000000000000000000
0000000000000000000000000000000000000000000000000000
0000000000000000000000000000000000000000000000000000
0000000000000000000000000000000000000000000000000000
0000000000000000000000000000000000000000000000000000