0000000000000000000000000000000000000000000000000000
0000000000000000000000000000000000000000000000000000
0000002222222000000000002200222220000000000000000000
0000002111112000000000002166111120000000000000000000
0000002111112000000000002111111120000000000000000000
0000002111112000000000002111111120000000000000000000
0000002111112222220000002111111120000000000000000000
0000002111111111120000002111111120000000000000000000
0000002111111111120000002111111120000000000000000000
0000002111112221120000002111111120000000000000000000
0000002222222021120000002111111120000000000000000000
0000000000000021122222222111111120000000000000000000
0000000000000021111111111111111120000000000000000000
0000000000000021111111111111111120000000000000000000
0000000000000022222112222111111120000000000000000000
0000000000000222222112222222222220000000000000000000
0000000000000211111111120000000000000000000000000000
0000000000000211111111120000000000000000000000000000
0000000000000211111111120000000000000000000000000000
0000000000000211111111120000000000000000000000000000
0000000000000211111111120000000000000000000000000000
0000000000000222222222220000000000000000000000000000
0000000000000000000000000000000000000000000000000000
0000000000000000000000000000000000000000000000000000
