0000000000000000000000000000000000000000000000000000
0000000000000000000000000000000000000000000000000000
0000200022222222222222220000000000000000000000000000
0000216611111111111111120000000000000000000000000000
0000211111111111111111120000000000000000000000000000
0000211111111111222221120000000000000000000000000000
0000211111111111200021120000000000000000000000000000
0000222222222222222221120000000000000000000000000000
0000211111111111111111120000000000000000000000000000
0000211111111111111111120000000000000000000000000000
0000211222222222222222220000000000000000000000000000
0000211111111111111111120000000000000000000000000000
0000211111111111111111120000000000000000000000000000
0000211111112222221111120000000000000000000000000000
0000211111112222221111120000000000000000000000000000
0000211111112211111111120000000000000000000000000000
0000211111112211111111120000000000000000000000000000
0000222222222211221111120000000000000000000000000000
0000000211111111221111120000000000000000000000000000
0000000211111111221111120000000000000000000000000000
0000000211111111221111120000000000000000000000000000
0000000211111111221111120000000000000000000000000000
0000000222222222222222220000000000000000000000000000
0000000000000000000000000000000000000000000000000000
0000000000000000000000000000000000000000000000000000
