0000000000000000000000000000000000000000000000000000
0000000000000000000000000000000000000000000000000000
0000000000000000000000000000000000000000000000000000
0000022222222222226622222000000000000000000000000000
0000028111118228171117182000000000000000000000000000
0000027311131221111411112000000000000000000000000000
0000021111111221131113112000000000000000000000000000
0000023111711221111111112000000000000000000000000000
0000021171111111111111112000000000000000000000000000
0000025131111111117113112000000000000000000000000000
0000022222221121111111512000000000000000000000000000
0000021835221121137115182000000000000000000000000000
0000023111223122222222222000000000000000000000000000
0000021111711111117111820000000000000000000000000000
0000021111111171111113120000000000000000000000000000
0000023111221122111171120000000000000000000000000000
0000028111221122117111120000000000000000000000000000
0000022211221122111171120000000000000000000000000000
0000021111111118111111320000000000000000000000000000
0000021111111111111113520000000000000000000000000000
0000022222222222222222220000000000000000000000000000
0000000000000000000000000000000000000000000000000000
0000000000000000000000000000000000000000000000000000
0000000000000000000000000000000000000000000000000000
0000000000000000000000000000000000000000000000000000