0000000000000000000000000000000000000000000000000000
0000000000000000000000000000000000000000000000000000
0000000222222000000000000000000000000000000000000000
0000000211112000000000006600000000000000000000000000
0000000211112222222222221120000000000000000000000000
0000000211112211111111111120000000000000000000000000
0000000211112211111111111120000000000000000000000000
0000000022112211111111112200000000000000000000000000
000000000211221111111111200000000000000000000000000
0022222222112222222221120000000000000000000000000000
0021111111111111111221120000000000000000000000000000
0021111111111111111221120000000000000000000000000000
0022221122221122211221120000000000000000000000000000
0022221122221120211221120000000000000000000000000000
0021111111111120211221120000000000000000000000000000
0021111111111120211221120000000000000000000000000000
0021111111111120211221120000000000000000000000000000
0021111111111120211111120000000000000000000000000000
0022222222222220211111120000000000000000000000000000
0000000000000000211111120000000000000000000000000000
0000000000000000222222220000000000000000000000000000
0000000000000000000000000000000000000000000000000000
0000000000000000000000000000000000000000000000000000
